{
    "world_descriptor": [
      [1, 1, 1, 1, 0, 1, 1, 1, 1],
      [1, 0, 0, 0, 0, 0, 0, 0, 1],
      [1, 0, 1, 1, 0, 1, 1, 0, 1],
      [1, 0, 1, 1, 0, 1, 1, 0, 1],
      [0, 0, 0, 0, 0, 0, 0, 0, 0],
      [1, 0, 1, 1, 0, 1, 1, 0, 1],
      [1, 0, 1, 1, 0, 1, 1, 0, 1],
      [1, 0, 0, 0, 0, 0, 0, 0, 1],
      [1, 1, 1, 1, 0, 1, 1, 1, 1]
    ],
    "bases": [
      [0, 4],
      [8, 4],
      [4, 0],
      [4, 8]
    ],
    "intermediate_positions": [ [4, 4]]
}